0000 0000 0000 2006 0005 0006 0000 0000 0000
0000 0000 0000 2006 0005 0006 0000 0000 0000
0000 0000 0000 2006 0005 0006 0000 0030 0000
0000 0000 0000 2006 0005 0006 0000 0000 0000
0000 0030 0000 2006 0005 0006 0000 0000 0000
0000 0000 0000 2006 0005 0006 0000 0000 0000