0204 0102 0102 0102 0102 0102 0102 0102 0102 0102 0102 0102 0102 0304 0009 0009
0002 0001 0001 0001 0001 0001 0001 0001 0001 0001 0001 0001 0001 0202 0009 0009
0002 0001 0001 0001 0001 0001 0001 0001 0001 0001 0001 0001 0001 0202 0009 0009
0002 0001 0001 0001 0001 0001 0001 0001 0001 0001 0001 0001 0001 0202 0009 0009
0002 0001 0001 0001 0001 0001 0001 0001 0001 0001 0001 0001 0001 0202 0009 0009
0002 0001 0001 0001 0001 0001 0001 0001 0001 0001 0001 0001 0001 0202 0009 0009
0002 0001 0001 0001 0001 0001 0001 0001 0001 0001 0001 0001 0001 0202 0009 0009
0002 0001 0001 0001 0001 0001 0001 0001 0001 0001 0001 0001 0001 0202 0009 0009
0002 0001 0001 0001 0001 0001 0001 0001 0001 0001 0001 0001 0001 0202 0009 0009
0002 0001 0001 0001 0001 0001 0001 0001 0001 0001 0001 0001 0001 0202 0009 0009
0002 0001 0001 0001 0001 0001 0001 0001 0001 0001 0001 0001 0001 0202 0009 0009
0002 0001 0001 0001 0001 0001 0001 0001 0001 0001 0001 0001 0001 0202 0009 0009
0002 0001 0001 0001 0001 0001 0001 0001 0001 0001 0001 0001 0001 0202 0009 0009
0104 0302 0302 0302 0302 0302 0302 0302 0302 0302 0302 0302 0302 0004 0009 0009