2004 1002 1002 1002 1002 1002 1002 1002 1002 1002 1002 1002 1002 1004
000A 0001 0001 0001 0001 0001 0001 0001 0001 0001 0001 0001 0001 2002
0002 0001 0001 0001 0001 0001 0001 0001 0001 0001 0001 0001 0001 2002
0002 0001 0001 0001 0001 0001 0001 0001 0001 0001 0001 0001 0001 2002
0002 0001 0001 0001 0001 0001 0001 0001 0001 0001 0001 0001 0001 2002
0002 0001 0001 0001 0001 0001 0001 0001 0001 0001 0001 0001 0001 2002
0002 0001 0001 0001 0001 0001 0001 0001 0001 0001 0001 0001 0001 2002
0002 0001 0001 0001 0001 0001 0001 0001 0001 0001 0001 0001 0001 2002
0002 0001 0001 0001 0001 0001 0001 0001 0001 0001 0001 0001 0001 2002
0002 0001 0001 0001 0001 0001 0001 0001 0001 0001 0001 0001 0001 2002
0002 0001 0001 0001 0001 0001 0001 0001 0001 0001 0001 0001 0001 2002
0002 0001 0001 0001 0001 0001 0001 0001 0001 0001 0001 0001 0001 2002
0002 0001 0001 0001 0001 0001 0001 0001 0001 0001 0001 0001 0001 2002
3004 3002 3002 3002 3002 3002 3002 3002 3002 3002 3002 3002 3002 0002