0412 0511 0511 0511 0511 0511 0511 0511 0511 0511 0512
0411 0210 0210 0210 0210 0210 0210 0210 0210 0210 0611
0411 0210 0210 0210 0210 0210 0210 0210 0210 0210 0611
0411 0210 0210 0210 0210 0210 0210 0210 0210 0210 0611
0411 0210 0210 0210 0210 0210 0210 0210 0210 0210 0611
0411 0210 0210 0210 0210 0210 0210 0210 0210 0210 0611
0411 0210 0210 0210 0210 0210 0210 0210 0210 0210 0611
0411 0210 0210 0210 0210 0210 0210 0210 0210 0210 0611
0411 0210 0210 0210 0210 0210 0210 0210 0210 0210 0611
0411 0210 0210 0210 0210 0210 0210 0210 0210 0210 0611
0712 0711 0711 0711 0711 0711 0711 0711 0711 0711 0612
